++++++++++++++++++++++
+S   +   ++ ++       +
+      +     +++++++++
+ +    ++  ++++ +++ ++
+ +++++ + ++    +++  +
+          ++  ++  + +
+++++ + + G    ++  + +
+++++ +++  + +  ++   +
+          + +  + +  +
+++++ +  + + +     + +
++++++++++++++++++++++